is=アイスランド語
az=アゼルバイジャン語
as=アッサム語
ga=アイルランド語
sa=サンスクリット語
af=アフリカーンス語
ar-ae=アラビア語/アラブ首長国連邦
ar-dz=アラビア語/アルジェリア
ar-ye=アラビア語/イエメン
ar-iq=アラビア語/イラク
ar-eg=アラビア語/エジプト
ar-om=アラビア語/オーマン
ar-qa=アラビア語/カタール
ar-kw=アラビア語/クウェート
ar-sa=アラビア語/サウジアラビア
ar-sy=アラビア語/シリア
ar-tn=アラビア語/チュニジア
ar-bh=アラビア語/バーレーン
ar-ma=アラビア語/モロッコ
ar-jo=アラビア語/ヨルダン
ar-ly=アラビア語/リビア
ar-lb=アラビア語/レバノン
ar=アラビア語
sq=アルバニア語
hy=アルメニア語
it=イタリア語
it-ch=イタリア語/スイス
yi=イディッシュ語
id=インドネシア語
uk=ウクライナ語
uz=ウズベク語
ur=ウルドゥー語
et=エストニア語
nl=オランダ語
nl-be=オランダ語/ベルギー語
or=オリヤー語
kk=カザフ語
ca=カタロニア語
kn=カナラ語
gl=ガリチア語
el=ギリシア語
kz=キルギスタン語
gu=グジャラート語
ka=グルジア語
hr=クロアチア語
sv=スウェーデン語
sv-fi=スウェーデン語/フィンランド
gd=スコッチ ゲール語
es=スペイン語/トラディショナル ソート
es-us=スペイン語/U.S
es-uy=スペイン語/ウルグアイ
es-ec=スペイン語/エクアドル
es-sv=スペイン語/エルサルバドル
es-gt=スペイン語/グアテマラ
es-cl=スペイン語/チリ
es-do=スペイン語/ドミニカ共和国
es-ar=スペイン語/アルゼンチン
es-co=スペイン語/コロンビア
es-cr=スペイン語/コスタリカ
es-es=スペイン語/スペイン
es-mx=スペイン語/メキシコ
es-ni=スペイン語/ニカラグア
es-pa=スペイン語/パナマ
es-py=スペイン語/パラグアイ
es-pr=スペイン語/プエルトリコ
es-ve=スペイン語/ベネズエラ
es-pe=スペイン語/ペルー
es-bo=スペイン語/ボリビア
es-hn=スペイン語/ホンジュラス
sk=スロヴァキア語
sl=スロヴェニア語
sw=スワヒリ語
sr=セルビア語
sb=ソルビア語
th=タイ語
cs=チェコ語
da=デンマーク語
de=ドイツ語
de-au=ドイツ語/オーストラリア
de-ch=ドイツ語/スイス
de-de=ドイツ語/ドイツ
de-at=ドイツ語/オーストリア
de-li=ドイツ語/リヒテンシュタイン
de-lu=ドイツ語/ルクセンブルク
tr=トルコ語
ne=ネパール語
no=ノルウェー語/ブークモール
nn-no=ノルウェー語/ニーノシク
nb-no=ノルウェー語/ブークモール
eu=バスク語
hu=ハンガリー語
fi=フィンランド語
fo=フェロー語
fr=フランス語
fr-ca=フランス語/カナダ
fr-ch=フランス語/スイス
fr-fr=フランス語/フランス
fr-be=フランス語/ベルギー
fr-mc=フランス語/モナコ
fr-lu=フランス語/ルクセンブルグ
bg=ブルアリア語
vi=ベトナム語
he=ヘブライ語
be=ベラルーシ語
fa=ペルシア語
bn=ベンガル語
pl=ポーランド語
pt=ポルトガル語
pt-br=ポルトガル語/ブラジル
mk=マケドニア語/旧ユーゴスラビア共和国
mr=マラーティー語
ml=マラヤラム語
mt=マルタ語
ms=マレー語/マレーシア
lv=ラトビア語
lt=リトニア語
ro-md=ルーマニア語/モルドバ
ro=ルーマニア語
rm=レートロマンス語
ru-mo=ロシア語/モルドバ
ru=ロシア語
en-gb=英語/英国
en-us=英語/米国
en-ie=英語/アイルランド
en-au=英語/オーストラリア
en-ca=英語/カナダ
en-jm=英語/ジャマイカ
en-zw=英語/ジンバブエ
en-tt=英語/トリニダード
en-nz=英語/ニュージーランド
en-ph=英語/フィリピン
en-bz=英語/ベリーズ
en-za=英語/南アフリカ
en=英語
ko=韓国語
ko-kr=韓国/韓国語
zh-sg=中国語/シンガポール
zh-hk=中国語/香港
zh-tw=中国語/台湾
zh-cn=中国語/中国
zh-mo=中国語/マカオ
zh=中国語
ja=日本語
ja-jp=日本語/日本
be=白ロシア語
xh=コーサ語
kok=コンカニ語
syr=シリア語]
zu=ズールー語
sx=スツ語
tt=タタール語
ta=タミール語
ts=ツォンガ語
tn=ツワナ語
div=ディヴェヒ語
te=テルグ語
pa=パンジャブ語
hi=ヒンディー語
mn=モンゴル語
